10 10
3111111111
1333333331
3131331113
3111111313
3113111311
3131111131
3131111131
3133333333
1111111111
3111121111