10 10
311111111131313
113333333133331
313133111331313
311111131333333
311311131111113
311111133333313
333333331113313
111111111311113
133333333333333
111111111111211