10 10
1333333133
1331311111
1131331113
3111111313
3113111311
3131111131
3131111131
3133333333
1111111111
3111121111